11111111111111
1P000000C0C0C1
1C111E00C01111
11111111110111
