111111111111111111111111111
1P0000111110001000000000001
100001C0010010C010011010001
1111001101C10000001100100C1
1C0E10000111111111111011111
101010CC000000000C0000000C1
101C10CC0111111011111100001
1001100001000010111111CCCC1
1000001100000C10111111CCCC1
111111111111111111111111111
